...###....
.....#.....
..........#
##........#
#...@..#..#
...........#
..#..#....#
.....#....#
.#.......
...........
.#........